3
13 9
11 0 0 0 2 2 5 0 0 0 0 0 0
0 1 2 1 0 1 0 1 0 1 2 1 0
0 6 2 0 2 0 0 2 2 2 0 2 0
0 1 0 1 0 1 0 1 0 1 0 1 0
0 2 0 0 0 0 0 0 0 0 5 0 2
0 1 0 1 0 1 2 1 0 1 0 1 0
0 0 0 0 0 0 2 3 2 0 0 0 2
0 1 2 1 2 1 0 1 0 1 0 1 0
0 0 0 2 0 2 0 0 0 5 0 2 6
6 1 0 1 0 0 11 0 2 1 0 1 0
2 2 5 0 0 0 1 0 2 0 5 0 0
1 1 1 1 1 0 1 0 1 1 1 1 1
6 2 2 2 0 0 1 0 0 0 2 0 0
0 1 1 1 0 7 1 7 2 1 1 1 6
2 0 2 0 0 0 1 0 0 0 0 2 2
1 1 1 1 1 0 1 2 1 1 1 1 1
0 0 5 0 2 0 1 0 2 0 5 0 2
0 1 9 1 2 0 0 2 0 1 2 1 3
2 2 1 11 1 0 0 1 0 10 1 0 3
6 2 1 0 1 2 0 1 0 0 1 2 1
2 0 5 0 1 2 1 1 0 1 1 7 0
1 1 1 2 1 0 8 0 0 1 2 0 0
2 2 1 0 1 0 0 2 2 1 2 1 1
0 2 1 0 1 1 1 1 0 0 0 5 0
7 1 1 0 2 0 0 1 2 2 1 1 2
0 6 1 1 2 1 0 0 0 5 1 0 2
0 2 0 2 2 1 0 2 0 0 1 0 9